25 40
0000000000000000000000000000000000000000
0                                      0
0                                      0
0     s  s  sss   s                    0
0     s  s   s    s                    0
0     ssss   s    s                    0
0     s  s   s                         0
0     s  s  sss   s                    0
0                                      0
0                                      0
0                                      0
0                                      0
0                                      0
0                                      0
0                                      0
0                                      0
0                                      0
0                                      0
0                                      0
0                                      0
0                                      0
0                                      0
0                                      0
0                                      0
0000000000000000000000000000000000000000