25 40
0000000000000000000000000000000000000000
0                                      0
0   sss  s s    sss ssss               0
0   s s  s s s  s s s  s               0
0   sss  s s  s s s ssss               0
0   s    s s s  s s ss                 0
0   s    s s    sss s s                0
0                                      0
0                                      0
0                                      0
0                                      0
0                                      0
0                                      0
0                                      0
0                                      0
0                                      0
0                                      0
0                                      0
0                                      0
0                                      0
0                                      0
0                                      0
0                                      0
0                                      0
0000000000000000000000000000000000000000